{
    "description": "Practice the alphabet.",
    "world_xz": 15,
    "world_y": 35,
    "shapes": [
        {
            "name": "F",
			"lifts": 0,
            "rotatable": 1,
			"highdice": 0,
            "color": "#FF0000; Red",
            "cubed": 5,
            "blocks": [
                0, 0, 0, 0, 0,
                0, 0, 0, 0, 0,
                0, 0, 0, 0, 0,
                0, 0, 0, 0, 0,
                0, 0, 0, 0, 0,
                
                0, 0, 0, 0, 0,
                0, 0, 0, 0, 0,
                0, 0, 0, 0, 0,
                0, 0, 0, 0, 0,
                0, 0, 0, 0, 0,
                
                0, 0, 1, 1, 1,
                0, 0, 1, 0, 0,
                0, 0, 1, 1, 0,
                0, 0, 1, 0, 0,
                0, 0, 1, 0, 0,
                
                0, 0, 0, 0, 0,
                0, 0, 0, 0, 0,
                0, 0, 0, 0, 0,
                0, 0, 0, 0, 0,
                0, 0, 0, 0, 0,
                
                0, 0, 0, 0, 0,
                0, 0, 0, 0, 0,
                0, 0, 0, 0, 0,
                0, 0, 0, 0, 0,
                0, 0, 0, 0, 0
            ]
        },
        {
            "name": "I/O",
			"lifts": 0,
            "rotatable": 1,
			"highdice": 0,
            "color": "#00FF00; Green",
            "cubed": 5,
            "blocks": [
                0, 0, 0, 0, 0,
                0, 0, 0, 0, 0,
                0, 0, 0, 0, 0,
                0, 0, 0, 0, 0,
                0, 0, 0, 0, 0,
                
                0, 0, 0, 0, 0,
                0, 0, 0, 0, 0,
                0, 0, 0, 0, 0,
                0, 0, 0, 0, 0,
                0, 0, 0, 0, 0,
                
                0, 0, 1, 0, 0,
                0, 0, 1, 0, 0,
                0, 0, 1, 0, 0,
                0, 0, 1, 0, 0,
                0, 0, 1, 0, 0,
                
                0, 0, 0, 0, 0,
                0, 0, 0, 0, 0,
                0, 0, 0, 0, 0,
                0, 0, 0, 0, 0,
                0, 0, 0, 0, 0,
                
                0, 0, 0, 0, 0,
                0, 0, 0, 0, 0,
                0, 0, 0, 0, 0,
                0, 0, 0, 0, 0,
                0, 0, 0, 0, 0
            ]
        },
        {
            "name": "L",
			"lifts": 0,
            "rotatable": 1,
			"highdice": 0,
            "color": "#0000FF; Blue",
            "cubed": 5,
            "blocks": [
                0, 0, 0, 0, 0,
                0, 0, 0, 0, 0,
                0, 0, 0, 0, 0,
                0, 0, 0, 0, 0,
                0, 0, 0, 0, 0,
                
                0, 0, 0, 0, 0,
                0, 0, 0, 0, 0,
                0, 0, 0, 0, 0,
                0, 0, 0, 0, 0,
                0, 0, 0, 0, 0,
                
                0, 0, 1, 0, 0,
                0, 0, 1, 0, 0,
                0, 0, 1, 0, 0,
                0, 0, 1, 0, 0,
                0, 0, 1, 1, 1,
                
                0, 0, 0, 0, 0,
                0, 0, 0, 0, 0,
                0, 0, 0, 0, 0,
                0, 0, 0, 0, 0,
                0, 0, 0, 0, 0,
                
                0, 0, 0, 0, 0,
                0, 0, 0, 0, 0,
                0, 0, 0, 0, 0,
                0, 0, 0, 0, 0,
                0, 0, 0, 0, 0
            ]
        },
        {
            "name": "N",
			"lifts": 0,
            "rotatable": 1,
			"highdice": 0,
            "color": "#FFFF00; Yellow",
            "cubed": 5,
            "blocks": [
                0, 0, 0, 0, 0,
                0, 0, 0, 0, 0,
                0, 0, 0, 0, 0,
                0, 0, 0, 0, 0,
                0, 0, 0, 0, 0,
                
                0, 0, 0, 0, 0,
                0, 0, 0, 0, 0,
                0, 0, 0, 0, 0,
                0, 0, 0, 0, 0,
                0, 0, 0, 0, 0,
                
                1, 0, 0, 0, 1,
                1, 1, 0, 0, 1,
                1, 1, 1, 1, 1,
                1, 0, 0, 1, 1,
                1, 0, 0, 0, 1,
                
                0, 0, 0, 0, 0,
                0, 0, 0, 0, 0,
                0, 0, 0, 0, 0,
                0, 0, 0, 0, 0,
                0, 0, 0, 0, 0,
                
                0, 0, 0, 0, 0,
                0, 0, 0, 0, 0,
                0, 0, 0, 0, 0,
                0, 0, 0, 0, 0,
                0, 0, 0, 0, 0
            ]
        },
        {
            "name": "P",
			"lifts": 0,
            "rotatable": 1,
			"highdice": 0,
            "color": "#00FFFF; Cyan",
            "cubed": 5,
            "blocks": [
                0, 0, 0, 0, 0,
                0, 0, 0, 0, 0,
                0, 0, 0, 0, 0,
                0, 0, 0, 0, 0,
                0, 0, 0, 0, 0,
                
                0, 0, 0, 0, 0,
                0, 0, 0, 0, 0,
                0, 0, 0, 0, 0,
                0, 0, 0, 0, 0,
                0, 0, 0, 0, 0,
                
                0, 0, 1, 1, 1,
                0, 0, 1, 0, 1,
                0, 0, 1, 1, 1,
                0, 0, 1, 0, 0,
                0, 0, 1, 0, 0,
                
                0, 0, 0, 0, 0,
                0, 0, 0, 0, 0,
                0, 0, 0, 0, 0,
                0, 0, 0, 0, 0,
                0, 0, 0, 0, 0,
                
                0, 0, 0, 0, 0,
                0, 0, 0, 0, 0,
                0, 0, 0, 0, 0,
                0, 0, 0, 0, 0,
                0, 0, 0, 0, 0
            ]
        },
        {
            "name": "T",
			"lifts": 0,
            "rotatable": 1,
			"highdice": 0,
            "color": "#FF00FF; Magenta",
            "cubed": 5,
            "blocks": [
                0, 0, 0, 0, 0,
                0, 0, 0, 0, 0,
                0, 0, 0, 0, 0,
                0, 0, 0, 0, 0,
                0, 0, 0, 0, 0,
                
                0, 0, 0, 0, 0,
                0, 0, 0, 0, 0,
                0, 0, 0, 0, 0,
                0, 0, 0, 0, 0,
                0, 0, 0, 0, 0,
                
                1, 1, 1, 1, 1,
                0, 0, 1, 0, 0,
                0, 0, 1, 0, 0,
                0, 0, 1, 0, 0,
                0, 0, 1, 0, 0,
                
                0, 0, 0, 0, 0,
                0, 0, 0, 0, 0,
                0, 0, 0, 0, 0,
                0, 0, 0, 0, 0,
                0, 0, 0, 0, 0,
                
                0, 0, 0, 0, 0,
                0, 0, 0, 0, 0,
                0, 0, 0, 0, 0,
                0, 0, 0, 0, 0,
                0, 0, 0, 0, 0
            ]
        },
        {
            "name": "U",
			"lifts": 0,
            "rotatable": 1,
			"highdice": 0,
            "color": "#800080; Purple",
            "cubed": 5,
            "blocks": [
                0, 0, 0, 0, 0,
                0, 0, 0, 0, 0,
                0, 0, 0, 0, 0,
                0, 0, 0, 0, 0,
                0, 0, 0, 0, 0,
                
                0, 0, 0, 0, 0,
                0, 0, 0, 0, 0,
                0, 0, 0, 0, 0,
                0, 0, 0, 0, 0,
                0, 0, 0, 0, 0,
                
                0, 1, 0, 1, 0,
                0, 1, 0, 1, 0,
                0, 1, 0, 1, 0,
                0, 1, 0, 1, 0,
                0, 1, 1, 1, 1,
                
                0, 0, 0, 0, 0,
                0, 0, 0, 0, 0,
                0, 0, 0, 0, 0,
                0, 0, 0, 0, 0,
                0, 0, 0, 0, 0,
                
                0, 0, 0, 0, 0,
                0, 0, 0, 0, 0,
                0, 0, 0, 0, 0,
                0, 0, 0, 0, 0,
                0, 0, 0, 0, 0
            ]
        }
	]
}
